#           B
# ########## 
# #########  
# ##     ## #
#    #   ##  
#### # ##### 
A    #       